4,  1, 5 63 36 0  0; 
4,  2, 5 63 36 0  1; 
4,  3, 5 63 36 0  2; 
4,  4  5 63 36 0  3;
4,  5, 5 63 36 0  4; 
4,  6, 5 63 36 0  5; 
4,  7, 5 63 36 0  6; 
4,  8, 5 63 36 0  7; 
4,  9, 5 63 36 0  8; 
4, 10, 5 63 36 0  9; 
4, 11, 5 63 36 0  10; 
4, 12, 5 63 36 0  11; 
